xxxxxxxxxxxxxxxx
x dx     x s sax
x  x vx  x   xsx
xx x  x sx   x x
xs    x  x   x x
xxxxxxx  x     x
x        x     x
x x xv         x
x x xxxxxxxxxxxx
x              x
xxsxvxsxvxsxvxfx
xxxxxxxxxxxxxxxx
